########################
#########***************
#########***************
#########**NEEEEEEEEEEEE
#########**N************
#########**N************
#########**N**##########
#########**N**##########
#########**N**##########
#########**N**##########
#########**N**##########
#########**N**##########
#########**N**##########
#########**N**##########
#########**N**##########
